#########E##
#Д##.####.##
##.#########
##....######
##...#######
##.##..*####
##......####
#.##########