#########E##
#.##.####.##
##.###.#####
##....###.##
##...#######
##.##..*####
##......####
#.##########