###E########
###.########
###...######
#####.######
#####.######
#####.######
#####*######
############