#########E##
#.##.####.##
##.#########
##....######
##...#######
##.##..*####
##......####
#.##########