########
###.####
###...##
#####.##
#####.##
########